Afghanistan – Islamic Republic of Afghanistan	UN member state	None	
Albania – Republic of Albania	UN member state	None	
Algeria – People's Democratic Republic of Algeria	UN member state	None	
Andorra – Principality of Andorra	UN member state	None	Andorra is a co-principality in which the office of head of state is jointly held ex officio by the French president and the bishop of the Roman Catholic diocese of Urgell,[2] who himself is appointed with approval from the Holy See.
Angola – Republic of Angola	UN member state	None	
Antigua and Barbuda	UN member state	None	Antigua and Barbuda is a Commonwealth realm[e] with 1 autonomous region, Barbuda.[f]
Argentina – Argentine Republic[g]	UN member state	None	Argentina is a federation of 23 provinces and 1 autonomous city.
Armenia – Republic of Armenia	UN member state	Not recognised by Pakistan.	Armenia is not recognised by Pakistan due to the dispute over Artsakh.[4][5][6]
rtsakh → Artsakh			
Australia – Commonwealth of Australia	UN member state	None	Australia is a Commonwealth realm[e] and a federation of six states and 10 territories. The external territories of Australia are:
Ashmore and Cartier Islands
Australian Antarctic Territory
Christmas Island
Cocos (Keeling) Islands
Coral Sea Islands Territory
Heard Island and McDonald Islands
Norfolk Island
Austria – Republic of Austria	UN member state	None	Member of the European Union.[c] Austria is a federation of nine states.
Azerbaijan – Republic of Azerbaijan	UN member state	None	Azerbaijan contains one autonomous region, Nakhchivan [f] The de facto state of Artsakh has been established in the southwest of Azerbaijan.
Bahamas, The – Commonwealth of The Bahamas[8]	UN member state	None	The Bahamas is a Commonwealth realm.[e]
Bahrain – Kingdom of Bahrain	UN member state	None	
Bangladesh – People's Republic of Bangladesh	UN member state	None	
Barbados	UN member state	None	Barbados is a Commonwealth realm.[e]
Belarus – Republic of Belarus	UN member state	None	
Belgium – Kingdom of Belgium	UN member state	None	Member of the EU.[c] Belgium is a federation divided into linguistic communities and regions.
Belize	UN member state	None	Belize is a Commonwealth realm.[e]
Benin – Republic of Benin	UN member state	None	
Bhutan – Kingdom of Bhutan	UN member state	None	
Bolivia – Plurinational State of Bolivia	UN member state	None	
Bosnia and Herzegovina	UN member state	None	Bosnia and Herzegovina is a federation of two constituent units:
Federation of Bosnia and Herzegovina
Republika Srpska
nd Brčko District, a self-governing administrative unit.[9]

Botswana – Republic of Botswana	UN member state	None	
Brazil – Federative Republic of Brazil	UN member state	None	Brazil is a federation of 26 states and 1 federal district.
Brunei – Nation of Brunei, the Abode of Peace	UN member state	None	
Bulgaria – Republic of Bulgaria	UN member state	None	Member of the EU.[c]
Burkina Faso	UN member state	None	
urma → Myanmar			
Burundi – Republic of Burundi	UN member state	None	
Cambodia – Kingdom of Cambodia	UN member state	None	
Cameroon – Republic of Cameroon	UN member state	None	
Canada[h]	UN member state	None	Canada is a Commonwealth realm[e] and a federation of 10 provinces and 3 territories.
Cape Verde – Republic of Cabo Verde[i]	UN member state	None	
Central African Republic	UN member state	None	
Chad – Republic of Chad	UN member state	None	
Chile – Republic of Chile	UN member state	None	
China – People's Republic of China[j]	UN member state	Partially unrecognised. Claimed by the Republic of China	China contains five autonomous regions, Guangxi, Inner Mongolia, Ningxia, Tibet, and Xinjiang.[f] Additionally, it has sovereignty over the Special Administrative Regions of:
Hong Kong
Macau
hina claims, but does not control Taiwan, which is governed by a rival administration (the Republic of China) that claims all of China as its territory.[k]

hina is not recognised by 16 UN member states and the Holy See, which, with the exception of Bhutan, all recognise Taiwan instead.[l]

hina, Republic of → Taiwan			
Colombia – Republic of Colombia	UN member state	None	
Comoros – Union of the Comoros	UN member state	None	Comoros is a federation of 3 islands.[m]
Congo, Democratic Republic of the[n]	UN member state	None	
Congo, Republic of the[o]	UN member state	None	
ook Islands → Cook Islands			
Costa Rica – Republic of Costa Rica	UN member state	None	
ôte d'Ivoire → Ivory Coast			
Croatia – Republic of Croatia	UN member state	None	Member of the EU.[c]
Cuba – Republic of Cuba	UN member state	None	
Cyprus – Republic of Cyprus	UN member state	Not recognised by Turkey[12]	Member of the EU.[c] The northeastern part of the island is the de facto state of Northern Cyprus.
yprus is not recognised by Turkey due to the Cyprus dispute, with Turkey recognising Northern Cyprus.

Czech Republic[p]	UN member state	None	Member of the EU.[c]
emocratic People's Republic of Korea → Korea, North			
emocratic Republic of the Congo → Congo, Democratic Republic of the			
Denmark – Kingdom of Denmark	UN member state	None	Member of the EU.[c] The Kingdom of Denmark includes 2 self-governing territories:
Faroe Islands
Greenland
he continental territory of Denmark, the Faroe Islands, and Greenland form the three constituent countries of the Kingdom.[q] The Kingdom of Denmark as a whole is a member of the EU, but EU law does not apply to the Faroe Islands and Greenland.[13][14]

Djibouti – Republic of Djibouti	UN member state	None	
Dominica – Commonwealth of Dominica	UN member state	None	
Dominican Republic	UN member state	None	
East Timor – Democratic Republic of Timor-Leste[r]	UN member state	None	
Ecuador – Republic of Ecuador	UN member state	None	
Egypt – Arab Republic of Egypt	UN member state	None	
El Salvador – Republic of El Salvador	UN member state	None	
Equatorial Guinea – Republic of Equatorial Guinea	UN member state	None	
Eritrea – State of Eritrea	UN member state	None	
Estonia – Republic of Estonia	UN member state	None	Member of the EU.[c]
Eswatini – Kingdom of Eswatini[s]	UN member state	None	
Ethiopia – Federal Democratic Republic of Ethiopia	UN member state	None	Ethiopia is a federation of nine regions and two chartered cities.
Fiji – Republic of Fiji	UN member state	None	Fiji contains 1 autonomous region, Rotuma.[f][15][16]
Finland – Republic of Finland	UN member state	None	Member of the EU.[c]
Åland is a neutral and demilitarised autonomous region of Finland.[f][t]
France – French Republic	UN member state	None	Member of the EU.[c] France contains five overseas regions/departments: French Guiana, Guadeloupe, Martinique, Mayotte, and Réunion. France also includes the overseas territories of:
Clipperton Island
French Polynesia
New Caledonia
Saint Barthélemy
Saint Martin
Saint Pierre and Miquelon
Wallis and Futuna
lag of the French Southern and Antarctic Lands.svg French Southern and Antarctic Lands
Gabon – Gabonese Republic	UN member state	None	
 Gambia, The – Republic of The Gambia[17]	UN member state	None	
Georgia	UN member state	None	Georgia contains two autonomous republics, Adjara and Abkhazia.[f] In Abkhazia and South Ossetia, de facto states have been formed.
Germany – Federal Republic of Germany	UN member state	None	Member of the EU.[c] Germany is a federation of 16 states.
Ghana – Republic of Ghana	UN member state	None	
Greece – Hellenic Republic	UN member state	None	Member of the EU.[c] Greece contains one autonomous area, Mount Athos.[18]
Grenada	UN member state	None	Grenada is a Commonwealth realm.[e]
Guatemala – Republic of Guatemala	UN member state	None	
Guinea – Republic of Guinea[u]	UN member state	None	
Guinea-Bissau – Republic of Guinea-Bissau	UN member state	None	
Guyana – Co-operative Republic of Guyana	UN member state	None	
Haiti – Republic of Haiti	UN member state	None	
oly See → Vatican City			
Honduras – Republic of Honduras	UN member state	None	
Hungary	UN member state	None	Member of the EU.[c]
Iceland[v]	UN member state	None	
India – Republic of India	UN member state	None	India is a federation of 28 states and nine union territories.
Indonesia – Republic of Indonesia	UN member state	None	Indonesia has five autonomous provinces, Aceh, Jakarta, Papua, West Papua, and Yogyakarta.[f]
Iran – Islamic Republic of Iran	UN member state	None	
Iraq – Republic of Iraq	UN member state	None	Iraq is a federation[m][22] of 19 governorates, five of which make up the autonomous Iraqi Kurdistan.[f]
Ireland[w]	UN member state	None	Member of the EU.[c]
Israel	UN member state	Partially unrecognised	Israel exerts strong control over the territory claimed by Palestine. Israel annexed East Jerusalem,[24] an annexation not recognised by the international community.[25] Israel maintains varying levels of control over the rest of the West Bank, and although Israel no longer has a permanent civilian or military presence in the Gaza Strip, following its unilateral disengagement, it is still considered by some to be the occupying power under international law.[26][27][28][29][30]
srael is not recognised as a state by 32 UN members and the Sahrawi Arab Democratic Republic. The Palestine Liberation Organization, which enjoys majority recognition as sole representative of the Palestinian people, also does not recognise Israel.

Italy – Italian Republic	UN member state	None	Member of the EU.[c] Italy has 5 autonomous regions, Aosta Valley, Friuli-Venezia Giulia, Sardinia, Sicily and Trentino-Alto Adige/Südtirol.[f]
Ivory Coast – Republic of Côte d'Ivoire[x]	UN member state	None	
Jamaica	UN member state	None	Jamaica is a Commonwealth realm.[e]
Japan	UN member state	None	
Jordan – Hashemite Kingdom of Jordan	UN member state	None	
Kazakhstan – Republic of Kazakhstan	UN member state	None	
Kenya – Republic of Kenya	UN member state	None	
Kiribati – Republic of Kiribati	UN member state	None	
Korea, North – Democratic People's Republic of Korea	UN member state	Claimed by South Korea	North Korea is not recognised by three UN members, France, Japan, and South Korea, the last of which claims to be the sole legitimate government of Korea.[31]
Korea, South – Republic of Korea	UN member state	Claimed by North Korea	South Korea has 1 autonomous region, Jejudo.[f][32]
outh Korea is not recognised by North Korea, which claims to be the sole legitimate government of Korea.

osovo → Kosovo			
Kuwait – State of Kuwait	UN member state	None	
Kyrgyzstan – Kyrgyz Republic	UN member state	None	
Laos – Lao People's Democratic Republic	UN member state	None	
Latvia – Republic of Latvia	UN member state	None	Member of the EU.[c]
Lebanon – Lebanese Republic	UN member state	None	
Lesotho – Kingdom of Lesotho	UN member state	None	
Liberia – Republic of Liberia	UN member state	None	
Libya – State of Libya	UN member state	None	
Liechtenstein – Principality of Liechtenstein	UN member state	None	
Lithuania – Republic of Lithuania	UN member state	None	Member of the EU.[c]
Luxembourg – Grand Duchy of Luxembourg	UN member state	None	Member of the EU.[c]
acedonia → North Macedonia			
Madagascar – Republic of Madagascar	UN member state	None	
Malawi – Republic of Malawi	UN member state	None	
Malaysia	UN member state	None	Malaysia is a federation of 13 states and three federal territories.
Maldives – Republic of Maldives	UN member state	None	
Mali – Republic of Mali	UN member state	None	
Malta – Republic of Malta	UN member state	None	Member of the EU.[c]
Marshall Islands – Republic of the Marshall Islands	UN member state	None	Under Compact of Free Association with the United States.
Mauritania – Islamic Republic of Mauritania	UN member state	None	
Mauritius – Republic of Mauritius	UN member state	None	Mauritius has an autonomous island, Rodrigues.[f]
Mexico – United Mexican States	UN member state	None	Mexico is a federation of 31 states and one autonomous city.
Federated States of Micronesia 	UN member state	None	Under Compact of Free Association with the United States. The Federated States of Micronesia is a federation of four states.
Moldova – Republic of Moldova	UN member state	None	Moldova has the autonomous regions of Gagauzia and Transnistria, the latter of which has established a de facto state.
Monaco – Principality of Monaco	UN member state	None	
Mongolia	UN member state	None	
Montenegro	UN member state	None	
Morocco – Kingdom of Morocco	UN member state	None	Part of the Moroccan-claimed Western Sahara is controlled by the partially recognised Sahrawi Arab Democratic Republic.
Mozambique – Republic of Mozambique	UN member state	None	
Myanmar – Republic of the Union of Myanmar[y]	UN member state	None	
agorno-Karabakh → Artsakh			
Namibia – Republic of Namibia	UN member state	None	
Nauru – Republic of Nauru	UN member state	None	
  Nepal – Federal Democratic Republic of Nepal	UN member state	None	Nepal is a federation composed of 7 provinces.
Netherlands – Kingdom of the Netherlands	UN member state	None	Member of the EU.[c] The Kingdom of the Netherlands includes four areas with substantial autonomy:
Aruba
Curaçao
Netherlands
Sint Maarten
he continental part of the Netherlands, Aruba, Curaçao, and Sint Maarten form the four constituent countries of the Kingdom. Three other territories (Bonaire, Saba, and Sint Eustatius) are special municipalities of the continental Netherlands.[z] The Kingdom of the Netherlands as a whole is a member of the EU, but EU law applies only to parts within Europe.

New Zealand	UN member state	None	New Zealand is a Commonwealth realm,[e] and has the dependent territories of:
Ross Dependency
Tokelau
ew Zealand has responsibilities for (but no rights of control over) two freely associated states:

Cook Islands
Niue
he Cook Islands and Niue have diplomatic relations with 49 and 18 UN members respectively.[33][34][35] They have full treaty-making capacity in the UN,[36] and are members of some UN specialized agencies.

Nicaragua – Republic of Nicaragua	UN member state	None	Nicaragua contains two autonomous regions, Atlántico Sur and Atlántico Norte.[f]
Niger – Republic of Niger	UN member state	None	
Nigeria – Federal Republic of Nigeria	UN member state	None	Nigeria is a federation of 36 states and 1 federal territory.
iue → Niue			
orth Korea → Korea, North			
North Macedonia – Republic of North Macedonia[aa]	UN member state	None	
orthern Cyprus → Northern Cyprus			
Norway – Kingdom of Norway	UN member state	None	
valbard is an integral part of Norway, but has a special status due to the Svalbard Treaty.
an Mayen is an island that is an integral part of Norway, although unincorporated.
orway has the dependent territories of:

ouvet Island
eter I Island
ueen Maud Land
Oman – Sultanate of Oman	UN member state	None	
Pakistan – Islamic Republic of Pakistan	UN member state	None	Pakistan is a federation of four provinces and 1 capital territory. Pakistan exercises control over certain portions of Kashmir, but has not officially annexed any of it,[37][38] instead regarding it as a disputed territory.[39][40] The portions that it controls are divided into two territories, administered separately from Pakistan proper:
Azad Kashmir
Gilgit Baltistan
zad Kashmir describes itself as a "self-governing state under Pakistani control", while Gilgit-Baltistan is described in its governance order as a group of "areas" with self-government.[41][42][43] These territories are not usually regarded as sovereign, as they do not fulfil the criteria set out by the declarative theory of statehood (for example, their current laws do not allow them to engage independently in relations with other states). Several state functions of these territories (such as foreign affairs and defence) are performed by Pakistan.[42][44][45]

Palau – Republic of Palau	UN member state	None	Under Compact of Free Association with the United States.
Palestine – State of Palestine	UN observer state; member of 2 UN specialized agencies	Partially unrecognised. Disputed by Israel	The State of Palestine, declared in 1988, is not recognised as a state by Israel and has received diplomatic recognition from 138 states.[46] The proclaimed state has no agreed territorial borders, or effective control over much of the territory that it proclaimed.[47] The Palestinian National Authority is an interim administrative body formed as a result of the Oslo Accords that exercises limited autonomous jurisdiction within the Palestinian territories. In foreign relations, Palestine is represented by the Palestine Liberation Organization.[48] The State of Palestine is a member state of UNESCO,[49] UNIDO, and an observer state in the UN.
Panama – Republic of Panama	UN member state	None	
Papua New Guinea – Independent State of Papua New Guinea	UN member state	None	Papua New Guinea is a Commonwealth realm[e] with 1 autonomous region, Bougainville.[f]
Paraguay – Republic of Paraguay	UN member state	None	
Peru – Republic of Peru	UN member state	None	
Philippines – Republic of the Philippines	UN member state	None	The Philippines contains one autonomous region, Bangsamoro.[f]
Poland – Republic of Poland	UN member state	None	Member of the EU.[c]
Portugal – Portuguese Republic	UN member state	None	Member of the EU.[c] Portugal contains two autonomous regions, the Azores and Madeira.[f]
ridnestrovie → Transnistria			
Qatar – State of Qatar	UN member state	None	
epublic of Korea → Korea, South			
epublic of the Congo → Congo, Republic of the			
Romania	UN member state	None	Member of the EU.[c]
Russia – Russian Federation	UN member state	None	Russia is a federation of 85 federal subjects (republics, oblasts, krais, autonomous okrugs, federal cities, and an autonomous oblast). Several of the federal subjects are ethnic republics.[f]
Rwanda – Republic of Rwanda	UN member state	None	
ahrawi Arab Democratic Republic → Sahrawi Arab Democratic Republic			
Saint Kitts and Nevis – Federation of Saint Christopher and Nevis	UN member state	None	Saint Kitts and Nevis is a Commonwealth realm[e] and is a federation[m] of two islands, St. Kitts and Nevis.
Saint Lucia	UN member state	None	Saint Lucia is a Commonwealth realm.[e]
Saint Vincent and the Grenadines	UN member state	None	Saint Vincent and the Grenadines is a Commonwealth realm.[e]
Samoa – Independent State of Samoa	UN member state	None	
San Marino – Republic of San Marino	UN member state	None	
São Tomé and Príncipe – Democratic Republic of São Tomé and Príncipe	UN member state	None	São Tomé and Príncipe contains 1 autonomous province, Príncipe.[f]
Saudi Arabia – Kingdom of Saudi Arabia	UN member state	None	
Senegal – Republic of Senegal	UN member state	None	
Serbia – Republic of Serbia	UN member state	None	Serbia contains two autonomous regions, Vojvodina and Kosovo and Metohija.[f] The latter is under the de facto control of Kosovo.
Seychelles – Republic of Seychelles	UN member state	None	
Sierra Leone – Republic of Sierra Leone	UN member state	None	
Singapore – Republic of Singapore	UN member state	None	
Slovakia – Slovak Republic	UN member state	None	Member of the EU.[c]
Slovenia – Republic of Slovenia	UN member state	None	Member of the EU.[c]
Solomon Islands	UN member state	None	The Solomon Islands is a Commonwealth realm.[e]
Somalia – Federal Republic of Somalia	UN member state	None	Somalia has two self-declared autonomous regions, Puntland and Galmudug, while the territory of Somaliland has formed an unrecognised de facto state.
omaliland → Somaliland			
South Africa – Republic of South Africa	UN member state	None	
outh Korea → Korea, South			
outh Ossetia → South Ossetia			
South Sudan – Republic of South Sudan	UN member state	None	South Sudan is a federation of 32 states.
he Abyei Area is a zone with "special administrative status" established by the Comprehensive Peace Agreement in 2005. It is de jure a condominium of South Sudan and Sudan, but de facto administered by two competing administrations and the United Nations.[50][51]
Spain – Kingdom of Spain	UN member state	None	Member of the EU.[c] Spain is divided into 17 autonomous communities and 2 special autonomous cities.[f]
Sri Lanka – Democratic Socialist Republic of Sri Lanka[ab]	UN member state	None	
Sudan – Republic of the Sudan	UN member state	None	Sudan is a federation of 18 states.
he Abyei Area is a zone with "special administrative status" established by the Comprehensive Peace Agreement in 2005. It is de jure a condominium of South Sudan and Sudan, but de facto administered by two competing administrations and the United Nations.[50][51]
udan, South → South Sudan			
Suriname – Republic of Suriname	UN member state	None	
waziland → Eswatini			
Sweden – Kingdom of Sweden	UN member state	None	Member of the EU.[c]
 Switzerland – Swiss Confederation	UN member state	None	Switzerland is a federation of 26 cantons.
Syria – Syrian Arab Republic	UN member state	None	The Syrian National Coalition, which is recognised as the legitimate representative of the Syrian people by 20 UN members, has established an interim government to rule rebel controlled territory during the Syrian civil war.
yria has one self-declared autonomous region: Rojava.

aiwan (Republic of China) → Taiwan			
Tajikistan – Republic of Tajikistan	UN member state	None	Tajikistan contains 1 autonomous region, Gorno-Badakhshan Autonomous Province.[f]
Tanzania – United Republic of Tanzania	UN member state	None	Tanzania contains 1 autonomous region, Zanzibar.[f]
Thailand – Kingdom of Thailand	UN member state	None	
he Bahamas → Bahamas, The			
he Gambia → Gambia, The			
imor-Leste → East Timor			
Togo – Togolese Republic	UN member state	None	
Tonga – Kingdom of Tonga	UN member state	None	
ransnistria → Transnistria			
Trinidad and Tobago – Republic of Trinidad and Tobago	UN member state	None	Trinidad and Tobago contains 1 autonomous region, Tobago.[f]
Tunisia – Republic of Tunisia	UN member state	None	
Turkey – Republic of Turkey	UN member state	None	
Turkmenistan	UN member state	None	
Tuvalu	UN member state	None	Tuvalu is a Commonwealth realm.[e]
Uganda – Republic of Uganda	UN member state	None	
Ukraine	UN member state	None	Ukraine claims Crimea as an autonomous republic, however it has been annexed by Russia.
United Arab Emirates	UN member state	None	The United Arab Emirates is a federation of seven emirates.
United Kingdom – United Kingdom of Great Britain and Northern Ireland	UN member state	None	Member of the EU.[c] The United Kingdom is a Commonwealth realm[e] consisting of four constituent countries: England, Northern Ireland, Scotland, and Wales. The United Kingdom has the following overseas territories:
Akrotiri and Dhekelia
Anguilla
Bermuda
British Indian Ocean Territory
British Virgin Islands
Cayman Islands
Falkland Islands
Gibraltar
Montserrat
Pitcairn Islands
lag of Saint Helena.svg Flag of Ascension Island.svg Flag of Tristan da Cunha.svg Saint Helena, Ascension and Tristan da Cunha
South Georgia and the South Sandwich Islands
Turks and Caicos Islands
British Antarctic Territory
he British monarch has direct sovereignty over three self-governing Crown dependencies:

Guernsey
Isle of Man
Jersey
United States – United States of America	UN member state	None	The United States is a federation of 50 states with shared sovereignty, 1 federal district, and 1 incorporated territory. Additionally, the Federal government of the United States has sovereignty over thirteen unincorporated territories. Of these territories the following are inhabited possessions:
American Samoa
Guam
Northern Mariana Islands
Puerto Rico
U.S. Virgin Islands
t also has sovereignty over several uninhabited territories:

aker Island
owland Island
arvis Island
ohnston Atoll
ingman Reef
idway Atoll
avassa Island
ake Island
t also disputes sovereignty over the following territories:

ajo Nuevo Bank
erranilla Bank
hree sovereign states have become associated states of the United States under the Compact of Free Association:

Marshall Islands – Republic of the Marshall Islands
Micronesia – Federated States of Micronesia
Palau – Republic of Palau
Uruguay – Oriental Republic of Uruguay	UN member state	None	
Uzbekistan – Republic of Uzbekistan	UN member state	None	Uzbekistan contains 1 autonomous region, Karakalpakstan.[f]
Vanuatu – Republic of Vanuatu	UN member state	None	
 Vatican City – Vatican City State	UN observer state under the designation of "Holy See"; member of three UN specialized agencies and the IAEA	None	Administered by the Holy See, a sovereign entity with diplomatic relations to 183 states. This figure consists of 180 UN member states, the Cook Islands, the Republic of China (Taiwan), and the State of Palestine.[52] In addition, the European Union and the Sovereign Military Order of Malta maintain diplomatic relations with the Holy See. The Holy See is a member of the IAEA, ITU, UPU, and WIPO and a permanent observer of the UN (in the category of "Non-member State")[48] and multiple other UN System organizations. The Vatican City is governed by officials appointed by the Pope, who is the Bishop of the Diocese of Rome and ex officio sovereign of Vatican City.
Venezuela – Bolivarian Republic of Venezuela	UN member state	None	Venezuela is a federation of 23 states, 1 capital district, and federal dependencies.
Vietnam – Socialist Republic of Vietnam	UN member state	None	
Yemen – Republic of Yemen	UN member state	None	
Zambia – Republic of Zambia	UN member state	None	
Zimbabwe – Republic of Zimbabwe	UN member state	None	
 UN member states and observer states ↑			
 Other states ↓			
Abkhazia – Republic of Abkhazia	No membership	Claimed by Georgia	Recognised by Russia, Nauru, Nicaragua, Venezuela, Artsakh, South Ossetia and Transnistria.[53] Claimed in whole by Georgia as the Autonomous Republic of Abkhazia.
Artsakh – Republic of Artsakh[ac]	No membership	Claimed by Azerbaijan	A de facto independent state,[54][55][56] recognised only by Abkhazia,[57] South Ossetia[57] and Transnistria.[57][58] Claimed in whole by Azerbaijan.[59]
Cook Islands	Member of eight UN specialized agencies	None
See political status)	A state in free association with New Zealand, the Cook Islands maintains diplomatic relations with 52 states. The Cook Islands is a member of multiple UN agencies with full treaty making capacity.[36] It shares a head of state with New Zealand as well as having shared citizenship.
Kosovo – Republic of Kosovo	Member of two UN specialized agencies	Partially recognized. Claimed by Serbia	Pursuant to United Nations Security Council Resolution 1244, Kosovo was placed under the administration of the United Nations Interim Administration Mission in Kosovo in 1999.[60] Kosovo declared independence in 2008, and it has received diplomatic recognition from 112 UN member states and the Republic of China, while 11 states have recognized Kosovo only to later withdraw their recognition. Serbia continues to maintain its sovereignty claim over Kosovo. Other UN member states and non UN member states continue to recognise Serbian sovereignty or have taken no position on the question. Kosovo is a member of the International Monetary Fund and the World Bank Group. The Republic of Kosovo has de facto control over most of the territory, with limited control in North Kosovo.
Niue	Member of five UN specialized agencies	None
See political status)	A state in free association with New Zealand, Niue maintains diplomatic relations with 20 states. Niue is a member of multiple UN agencies with full treaty making capacity.[36] It shares a head of state with New Zealand as well as having shared citizenship.
Northern Cyprus – Turkish Republic of Northern Cyprus	No membership	Claimed by the Republic of Cyprus	Recognised only by Turkey. Under the name "Turkish Cypriot State", it is an observer state of the Organisation of Islamic Cooperation and the Economic Cooperation Organization. Northern Cyprus is claimed in whole by the Republic of Cyprus.[61]
Sahrawi Arab Democratic Republic	No membership	Claimed by Morocco	Recognised at some stage by 84 UN member states, 42 of which have since withdrawn or frozen their recognition. It is a founding member of the African Union and the Asian–African Strategic Partnership formed at the 2005 Asian–African Conference. The territories under its control, the so-called Free Zone, are claimed in whole by Morocco as part of its Southern Provinces. In turn, the Sahrawi Arab Democratic Republic claims the part of Western Sahara to the west of the Moroccan Wall controlled by Morocco. Its government resides in exile in Tindouf, Algeria.
Somaliland – Republic of Somaliland	No membership	Claimed by Somalia	A de facto independent state,[54][62][63][64][65] not diplomatically recognised by any other state, claimed in whole by the Federal Republic of Somalia.[66]
South Ossetia – Republic of South Ossetia–the State of Alania	No membership	Claimed by Georgia	A de facto independent state,[67] recognised by Russia, Nicaragua, Nauru, Syria, Venezuela, Abkhazia, Artsakh and Transnistria. Claimed in whole by Georgia as the Provisional Administrative Entity of South Ossetia.[68]
Taiwan – Republic of China[j]	Former UN member (as Republic of China, 1945–1971)
